1111111111111
10010000000C1
1000011111001
1P0011E000011
1111111111111
1111111111111
1001000000001
1000011111001
100011E000011
1111111111111