1111111
1000001
100P001
1111111
