1111111111111
10010000001C1
1000011111011
1P0011E100001
1111111111111