1111111111111111111111111111
1CE00001000A01C0000001000001
1P00000000100000001C11000001
1000000001100100A100A1000001
1111111111111111101010100001
10C00C00CCCC0100001010000111
10C00C00000C01001A0001000001
10CCCC000CCC0100011001000001
10000C00C0000000000001000001
1A000CA0CCCC0100000001000001
1111111111111111111111111111